111111111111111
1000P00C0E0C001
111111111111111