1111111111111111111111111
1P00000000100000000000001
1111011111011111111101111
10000100000100000C0000001
1011110111110111111111101
1000000100000100000000001
1001111101111101111111101
1001000001000001000000001
1011011111011101111111101
1000010000000001000000C01
1111010111111101111111101
1C000010000000000C00000E1
1111111111111111111111111