111111111111111
1000P000C010C01
10000E000000001
111111111111111